11111111111
1000000E101
100CCC00001
1P0000CC001
11111111111