11111111111
1000000E101
1C00C00C001
1P0000000C1
11111111111