11111111111
1000000E101
11111011111
1P0000CC001
11111111111