11111111111
1E000000011
11110001111
1P00000C101
11111111111