111111111
1000000P1
10E1100C1
10010C001
111111111