11111111111
10P000C0011
100000C0011
100CE0000C1
11111111111